###############
#             #
#    # # ## # #
# #  ##    ####
#       #### ##
#  # #        #
# ## #   ##   #
# ##  #   ### #
#        #    #
### #  ### ## #
##  #  # #    #
## ##  #   # ##
#       ##   ##
# # #    #    #
###############